████████████████████████
█     █       █       ██
█ ██ ███ ████ █ ███ ████
█ █      █       ██    █
█ ███ ██ █ █████████ ███
█   █    █   █       █ F
███ █ ████ █ ██ ███ ██ █
█     █    █      █    █
████████████████████████